111111111111111111111111
10000M00100M00C110000001
1C0000001000000000C11001
10000M00C000M00100000011
10000000100M000000000001
1E00000M000000C11100P001
111111111111111111111111
